20
20
XXXXXXXXXXXXXXXXXXXX
X@@@@XXXXXXXXXXXXXXX
X@@@@X#############!
X@@@@X#XXXX#XXXXXXXX
X@@@@X#X@@X#X@@@@@@X
X@@@@X#X@@X#X@@@@@@X
XXXXXX#XXXX#X@@@@@@X
!###########XXXXXXXX
XXXX#XXXXXX#######XX
X@@X#X@@@@X#XXXXX#XX
X@@X#XXXXXX#X@@@X#XX
X@@X########X@@@X##!
X@@X#XXX#XX#XXXXXXXX
XXXX#X@X#XX#####X@@X
XX###X@X#XXXXXX#X@@X
XX#XXX@X#X@@@@X#X@@X
XX#XXXXX#XXXXXX#X@@X
XX##############X@@X
XXXXXXXXX#XXXXXXX@@X
XXXXXXXXX+XXXXXXXXXX